############################
#                          #
# ########### ##############
#                          #
#  #########################
#  #                       #
# ##                    ####
#                          #
############################