############################
# ..........               #
# ########### ##############
#           ........       #
#  #########################
#  #                       #
# ##                    ####
#                          #
############################